Start Date,End Date,Unvaccinated,One Prior MMR,Two Prior MMR,Unknown MMR,Total
2018-09-01,2019-05-13,377,32,22,67,498
2018-09-01,2019-05-20,391,34,22,76,523
2018-09-01,2019-05-24,396,36,24,79,535
2018-09-01,2019-05-29,405,39,27,79,550
2018-09-01,2019-06-03,415,41,27,83,566
2018-09-01,2019-06-10,429,42,27,90,588
2018-09-01,2019-06-24,443,44,27,95,609
2018-09-01,2019-07-15,453,45,28,97,623
2018-09-01,2019-07-22,461,46,31,99,637
2018-09-01,2019-07-29,466,46,31,99,642
